1111111111111111
1000000000000001
1000000000000001
1000111110000001
1000100000000001
1000111100000001
1000000000000001
1111111111111111