NO ./textures/north.xpm
SO ./textures/south.xpm
WE ./textures/west.xpm
EA ./textures/east.xpm

F 200,4,200
C 135,206,235

111111111
111110011
1000N0111
100000001
11111111
