NO ./textures/north.xpm
SO ./textures/south.xpm
WE ./textures/west.xpm
EA ./textures/east.xpm

F 220,100,0
C 225,30,0

111111111111111111111
100000000011000000001
101100000111000000001
10010000000000N000001
100100000000000000001
100100000011000000001
100100000000000000001
111111111111111111111
